10x40* o12
****************************************
* *                      **            *
*                       *              *
* ****                                 *
*  *                                   *
*  ** *              *****             *
*     * *           *                  *
***  **              ****              *
1     ***               *              2
****************************************