10x40* o12
*2**************************************
* *                      **            *
*                       *              *
* ****                                 *
*  *                                   *
*  ** *              *****             *
*     * *           *                  *
***  **              ****              *
1     ***               *              *
****************************************